1 13 31
###############################
#p ss  ** *  1 * 2 *  * * *   #
# # # #*# # #*#*# # # #*#*#*# #
#  s*   b ***  *  1   * 2 * * #
# # # # # #*# # #*#*# # # # #*#
#f     b   x **  *  *   1     #
# # # # # # # # # #*# #*# # # #
#* f* 3    *  *      *        #
# # # # #*# # # #*#*# # # # # #
#*    **  *       *           #
# #*# # # # # # #*# # # # # # #
#       3   *   *  *          #
###############################